1000000100000000000000000000000
0000000100000000000000000000000
0000000100000000000000000000000
0000000100000000000000000000000
0000000000000000000000000000000
0000000000111111100000000000000
0000000000000000000000000000000
000000P000000000000000P00000000
0000000000000000000000200000000
0000111100000001111111111111000
0000222211111112222222222222000
0010022222222222222222222220000
0000000222222222222222222200000
0000000220022202220222000000000
0000000000002200200000000000000
0000000000000000000000000000000
0000000000000000000000000000000
1111111100000000000000000000000

